absolute threshold — the minimum stimulus energy needed to detect a particular stimulus 50 percent of the time. (p. 163)
accommodation — (1) in sensation and perception, the process by which the eye’s lens changes shape to focus near or far objects on the retina. (2) in developmental psychology, adapting our current understandings (schemas) to incorporate new information. (pp. 177, 498)
achievement motivation — a desire for significant accomplishment, for mastery of skills or ideas, for control, and for attaining a high standard. (p. 428)
achievement test — a test designed to assess what a person has learned. (p. 632)
acquisition — in classical conditioning, the initial stage, when one links a neutral stimulus and an unconditioned stimulus so that the neutral stimulus begins triggering the conditioned response. In operant conditioning, the strengthening of a reinforced response. (p. 275)
action potential — a neural impulse; a brief electrical charge that travels down an axon. (p. 83)
active listening — empathic listening in which the listener echoes, restates, and clarifies. A feature of Rogers’ client-centered therapy. (p. 726)
acute schizophrenia — (also called reactive schizophrenia) a form of schizophrenia that can begin at any age; frequently occurs in response to a traumatic event. (p. 701)
adaptation-level phenomenon — our tendency to form judgments (of sounds, of lights, of income) relative to a neutral level defined by our prior experience. (p. 476)
adolescence — the transition period from childhood to adulthood, extending from puberty to independence. (p. 533)
adrenal — a pair of endocrine glands that sit just above the kidneys and secrete hormones (epinephrine and norepinephrine) that help arouse the body in times of stress. (p. 95)
aerobic exercise — sustained exercise that increases heart and lung fitness; also helps alleviate depression and anxiety. (p. 467)
affiliation need — the need to build relationships and to feel part of a group. (p. 423)
aggression — any physical or verbal behavior intended to harm someone physically or emotionally. (pp. 521, 801)
agonist — a molecule that increases a neurotransmitter’s action. (p. 88)
agoraphobia — fear or avoidance of situations, such as crowds or wide open places, where one has felt loss of control and panic. (p. 678)
AIDS (acquired immune deficiency syndrome) — a life-threatening, sexually transmitted infection caused by the human immunodeficiency virus (HIV). AIDS depletes the immune system, leaving the person vulnerable to infections. (p. 547)
alcohol use disorder — (popularly known as alcoholism) alcohol use marked by tolerance, withdrawal, and a drive to continue problematic use. (p. 255)
algorithm — a methodical, logical rule or procedure that guarantees solving a particular problem. Contrasts with the usually speedier—but also more error-prone—use of heuristics. (p. 370)
all-or-none response — a neuron’s reaction of either firing (with a full-strength response) or not firing. (p. 83)
alpha waves — the relatively slow brain waves of a relaxed, awake state. (p. 232)
altruism — unselfish regard for the welfare of others. (p. 816)
Alzheimer’s disease — a neurocognitive disorder marked by neural plaques, often with onset after age 80, and entailing a progressive decline in memory and other cognitive abilities. (p. 563)
amphetamines — drugs, such as methamphetamine, that stimulate neural activity, causing accelerated body functions and associated energy and mood changes. (p. 260)
amygdala — [uh-MIG-duh-la] two lima-bean-sized neural clusters in the limbic system; linked to emotion. (p. 104)
androgyny — displaying both traditional masculine and feminine psychological characteristics. (p. 526)
anorexia nervosa — an eating disorder in which a person (usually an adolescent female) maintains a starvation diet despite being significantly underweight; sometimes accompanied by excessive exercise. (p. 712)
antagonist — a molecule that inhibits or blocks a neurotransmitter’s action. (p. 89)
anterograde amnesia — an inability to form new memories. (p. 351)
antianxiety drugs — drugs used to control anxiety and agitation. (p. 754)
antidepressant drugs — drugs used to treat depression, anxiety disorders, obsessive-compulsive disorder, and posttraumatic stress disorder. (Several widely used antidepressant drugs are selective serotonin reuptake inhibitors— SSRIs.) (p. 754)
antipsychotic drugs — drugs used to treat schizophrenia and other forms of severe thought disorder. (p. 753)
antisocial personality disorder — a personality disorder in which a person (usually a man) exhibits a lack of conscience for wrongdoing, even toward friends and family members; may be aggressive and ruthless or a clever con artist. (p. 710)
anxiety disorders — psychological disorders characterized by distressing, persistent anxiety or maladaptive behaviors that reduce anxiety. (p. 677)
aphasia — impairment of language, usually caused by left hemisphere damage either to Broca’s area (impairing speaking) or to Wernicke’s area (impairing understanding). (p. 387)
applied research — scientific study that aims to solve practical problems. (p. 24)
aptitude test — a test designed to predict a person’s future performance; aptitude is the capacity to learn. (p. 632)
asexual — having no sexual attraction to others. (p. 418)
assimilation — interpreting our new experiences in terms of our existing schemas. (p. 498)
association areas — areas of the cerebral cortex that are not involved in primary motor or sensory functions; rather, they are involved in higher mental functions such as learning, remembering, thinking, and speaking. (p. 114)
associative learning — learning that certain events occur together. The events may be two stimuli (as in classical conditioning) or a response and its consequence (as in operant conditioning). (p. 271)
attachment — an emotional tie with another person; shown in young children by their seeking closeness to their caregiver and showing distress on separation. (p. 509)
attention-deficit/hyperactivity disorder (ADHD) — a psychological disorder marked by extreme inattention and/or hyperactivity and impulsivity. (p. 670)
attitude — feelings, often influenced by our beliefs, that predispose us to respond in a particular way to objects, people, and events. (p. 770)
attribution theory — the theory that we explain someone’s behavior by crediting either the situation or the person’s disposition. (p. 768)
audition — the sense or act of hearing. (p. 198)
autism spectrum disorder (ASD) — a disorder that appears in childhood and is marked by significant deficiencies in communication and social interaction, and by rigidly fixated interests and repetitive behaviors. (p. 505)
automatic processing — unconscious encoding of incidental information, such as space, time, and frequency, and of well-learned information, such as word meanings. (p. 331)
autonomic — the part of the peripheral nervous system that controls the glands and the muscles of the internal organs (such as the heart). Its sympathetic division arouses; its parasympathetic division calms. (p. 93)
availability heuristic — estimating the likelihood of events based on their availability in memory; if instances come readily to mind (perhaps because of their vividness), we presume such events are common. (p. 373)
aversive conditioning — a type of counterconditioning that associates an unpleasant state (such as nausea) with an unwanted behavior (such as drinking alcohol). (p. 731)
axon — the neuron extension that passes messages through its branches to other neurons or to muscles or glands. (p. 82)
babbling stage — beginning around 4 months, the stage of speech development in which an infant spontaneously utters various sounds at first unrelated to the household language. (p. 384)
barbiturates — drugs that depress central nervous system activity, reducing anxiety but impairing memory and judgment. (p. 257)
basal metabolic rate — the body’s resting rate of energy output. (p. 411)
basic research — pure science that aims to increase the scientific knowledge base. (p. 24)
basic trust — according to Erik Erikson, a sense that the world is predictable and trustworthy; said to be formed during infancy by appropriate experiences with responsive caregivers. (p. 513)
behavior feedback effect — the tendency of behavior to influence our own and others’ thoughts, feelings, and actions. (p. 448)
behavior genetics — the study of the relative power and limits of genetic and environmental influences on behavior. (pp. 14, 129)
behavior therapy — therapy that applies learning principles to the elimination of unwanted behaviors. (p. 729)
behavioral approach — focuses on the effects of learning on our personality development. (p. 606)
behavioral psychology — the scientific study of observable behavior, and its explanation by principles of learning. (p. 17)
behaviorism — the view that psychology (1) should be an objective science that (2) studies behavior without reference to mental processes. Most psychologists today agree with (1) but not with (2). (pp. 10, 272)
belief perseverance — clinging to one’s initial conceptions after the basis on which they were formed has been discredited. (p. 376)
binge-eating disorder — significant binge-eating episodes, followed by distress, disgust, or guilt, but without the compensatory behavior that marks bulimia nervosa. (p. 713)
binocular cue — a depth cue, such as retinal disparity, that depends on the use of two eyes. (p. 189)
biofeedback — a system for electronically recording, amplifying, and feeding back information regarding a subtle physiological state, such as blood pressure or muscle tension. (p. 296)
biological psychology — the scientific study of the links between biological (genetic, neural, hormonal) and psychological processes. (Some biological psychologists call themselves behavioral neuroscientists, neuropsychologists, behavior geneticists, physiological psychologists, or biopsychologists.) (p. 17)
biomedical therapy — prescribed medications or procedures that act directly on the person’s physiology. (p. 722)
biopsychosocial approach — an integrated approach that incorporates biological, psychological, and social-cultural viewpoints. (p. 17)
bipolar disorder — a disorder in which a person alternates between the hopelessness and lethargy of depression and the overexcited state of mania. (Formerly called manic-depressive disorder.) (p. 687)
blind spot — the point at which the optic nerve leaves the eye, creating a “blind” spot because no receptor cells are located there. (p. 179)
blindsight — a condition in which a person can respond to a visual stimulus without consciously experiencing it. (p. 125)
bottom-up processing — analysis that begins with the sensory receptors and works up to the brain’s integration of sensory information. (p. 158)
brainstem — the oldest part and central core of the brain, beginning where the spinal cord swells as it enters the skull; the brainstem is responsible for automatic survival functions. (p. 102)
Broca’s area — helps control language expression—an area of the frontal lobe, usually in the left hemisphere, that directs the muscle movements involved in speech. (p. 388)
bulimia nervosa — an eating disorder in which a person’s binge eating (usually of high-calorie foods) is followed by inappropriate weight-loss promoting behavior, such as vomiting, laxative use, fasting, or excessive exercise. (p. 713)
bystander effect — the tendency for any given bystander to be less likely to give aid if other bystanders are present. (p. 817)
Cannon-Bard theory — the theory that an emotion-arousing stimulus simultaneously triggers (1) physiological responses and (2) the subjective experience of emotion. (p. 433)
case study — a descriptive technique in which one individual or group is studied in depth in the hope of revealing universal principles. (p. 44)
catharsis — in psychology, the idea that “releasing” aggressive energy (through action or fantasy) relieves aggressive urges. (p. 460)
cell body — the part of a neuron that contains the nucleus; the cell’s life-support center. (p. 82)
central nervous system (CNS) — the brain and spinal cord. (p. 92)
central route persuasion — occurs when interested people focus on the arguments and respond with favorable thoughts. (p. 771)
cerebellum — [sehr-uh-BELL-um] the “little brain” at the rear of the brainstem; functions include processing sensory input, coordinating movement output and balance, and enabling nonverbal learning and memory. (p. 103)
cerebral — the intricate fabric of interconnected neural cells covering the cerebral hemispheres; the body’s ultimate control and information-processing center. (p. 109)
change blindness — failing to notice changes in the environment; a form of inattentional blindness. (p. 161)
chromosomes — threadlike structures made of DNA molecules that contain the genes. (p. 130)
chronic schizophrenia — (also called process schizophrenia) a form of schizophrenia in which symptoms usually appear by late adolescence or early adulthood. As people age, psychotic episodes last longer and recovery periods shorten. (p. 700)
chunking — organizing items into familiar, manageable units; often occurs automatically. (p. 333)
circadian — our biological clock; regular bodily rhythms (for example, of temperature and wakefulness) that occur on a 24-hour cycle. (p. 231)
classical conditioning — a type of learning in which we link two or more stimuli; as a result, to illustrate with Pavlov’s classic experiment, the first stimulus (a tone) comes to elicit behavior (drooling) in anticipation of the second stimulus (food). (p. 272)
client-centered therapy — a humanistic therapy, developed by Carl Rogers, in which the therapist uses techniques such as active listening within an accepting, genuine, empathic environment to facilitate clients’ growth. (Also called person-centered therapy.) (p. 725)
clinical psychology — a branch of psychology that studies, assesses, and treats people with psychological disorders. (p. 25)
cocaine — a powerful and addictive stimulant derived from the coca plant; produces temporarily increased alertness and euphoria. (p. 259)
cochlea — [KOHK-lee-uh] a coiled, bony, fluid-filled tube in the inner ear; sound waves traveling through the cochlear fluid trigger nerve impulses. (p. 199)
cochlear implant — a device for converting sounds into electrical signals and stimulating the auditory nerve through electrodes threaded into the cochlea. (p. 201)
cognition — all the mental activities associated with thinking, knowing, remembering, and communicating. (pp. 365, 498)
cognitive dissonance theory — the theory that we act to reduce the discomfort (dissonance) we feel when two of our thoughts (cognitions) are inconsistent. For example, when we become aware that our attitudes and our actions clash, we can reduce the resulting dissonance by changing our attitudes. (p. 773)
cognitive learning — the acquisition of mental information, whether by observing events, by watching others, or through language. (p. 272)
cognitive map — a mental representation of the layout of one’s environment. For example, after exploring a maze, rats act as if they have learned a cognitive map of it. (p. 304)
cognitive neuroscience — the interdisciplinary study of the brain activity linked with cognition (including perception, thinking, memory, and language). (pp. 13, 124)
cognitive psychology — the study of mental processes, such as occur when we perceive, learn, remember, think, communicate, and solve problems. (p. 13)
cognitive therapy — therapy that teaches people new, more adaptive ways of thinking; based on the assumption that thoughts intervene between events and our emotional reactions. (p. 733)
cognitive-behavioral therapy (CBT) — a popular integrative therapy that combines cognitive therapy (changing self-defeating thinking) with behavior therapy (changing behavior). (p. 736)
cohort — a group of people sharing a common characteristic, such as from a given time period. (p. 640)
collective unconscious — Carl Jung’s concept of a shared, inherited reservoir of memory traces from our species’ history. (p. 583)
collectivism — giving priority to the goals of one’s group (often one’s extended family or work group) and defining one’s identity accordingly. (p. 616)
color constancy — perceiving familiar objects as having consistent color, even if changing illumination alters the wavelengths reflected by the object. (p. 192)
community psychology — a branch of psychology that studies how people interact with their social environments and how social institutions affect individuals and groups. (p. 25)
companionate love — the deep affectionate attachment we feel for those with whom our lives are intertwined. (p. 813)
concept — a mental grouping of similar objects, events, ideas, or people. (p. 365)
concrete operational stage — in Piaget’s theory, the stage of cognitive development (from about 7 to 11 years of age) during which children gain the mental operations that enable them to think logically about concrete events. (p. 502)
conditioned reinforcer — a stimulus that gains its reinforcing power through its association with a primary reinforcer; also known as a secondary reinforcer. (p. 286)
conditioned response (CR) — in classical conditioning, a learned response to a previously neutral (but now conditioned) stimulus (CS). (p. 274)
conditioned stimulus (CS) — in classical conditioning, an originally neutral stimulus that, after association with an unconditioned stimulus (US), comes to trigger a conditioned response (CR). (p. 274)
conduction hearing loss — a less common form of hearing loss, caused by damage to the mechanical system that conducts sound waves to the cochlea. (p. 200)
cones — retinal receptors that are concentrated near the center of the retina and that function in daylight or in well-lit conditions. Cones detect fine detail and give rise to color sensations. (p. 178)
confirmation bias — a tendency to search for information that supports our preconceptions and to ignore or distort contradictory evidence. (p. 371)
conflict — a perceived incompatibility of actions, goals, or ideas. (p. 819)
conformity — adjusting our behavior or thinking to coincide with a group standard. (p. 776)
confounding variable — a factor other than the factor being studied that might influence a study’s results. (p. 56)
consciousness — our subjective awareness of ourselves and our environment. (pp. 123, 224)
conservation — the principle (which Piaget believed to be a part of concrete operational reasoning) that properties such as mass, volume, and number remain the same despite changes in the forms of objects. (p. 501)
content validity — the extent to which a test samples the behavior that is of interest. (p. 637)
continuous reinforcement schedule — reinforcing the desired response every time it occurs. (p. 287)
control group — in an experiment, the group not exposed to the treatment; contrasts with the experimental group and serves as a comparison for evaluating the effect of the treatment. (p. 54)
convergent thinking — narrowing the available problem solutions to determine the single best solution. (p. 366)
conversion disorder — a disorder related to somatic symptom disorder in which a person experiences very specific, physical symptoms that are not compatible with recognized medical or neurological conditions. (Also called functional neurological symptom disorder.) (p. 707)
cornea — the eye’s clear, protective outer layer, covering the pupil and iris. (p. 177)
coronary heart disease — the clogging of the vessels that nourish the heart muscle; the leading cause of death in many developed countries. (p. 459)
corpus callosum — [KOR-pus kah-LOW-sum] the large band of neural fibers connecting the two brain hemispheres and carrying messages between them. (p. 120)
correlation — a measure of the extent to which two factors vary together, and thus of how well either factor predicts the other. (p. 51)
correlation coefficient — a statistical index of the relationship between two things (from −1.00 to +1.00). (p. 51)
counseling psychology — a branch of psychology that assists people with problems in living (often related to school, work, or marriage) and in achieving greater well-being. (p. 25)
counterconditioning — behavior therapy procedures that use classical conditioning to evoke new responses to stimuli that are triggering unwanted behaviors; include exposure therapies and aversive conditioning. (p. 729)
creativity — the ability to produce new and valuable ideas. (p. 366)
critical period — an optimal period early in the life of an organism when exposure to certain stimuli or experiences produces normal development. (p. 510)
critical thinking — thinking that does not blindly accept arguments and conclusions. Rather, it examines assumptions, appraises the source, discerns hidden biases, evaluates evidence, and assesses conclusions. (p. 4)
cross-sectional study — research that compares people of different ages at the same point in time. (pp. 563, 640)
crystallized intelligence — our accumulated knowledge and verbal skills; tends to increase with age. (p. 640)
CT (computed tomography) scan — a series of X-ray photographs taken from different angles and combined by computer into a composite representation of a slice of the brain’s structure. (Also called CAT scan.) (p. 99)
culture — the enduring behaviors, ideas, attitudes, values, and traditions shared by a group of people and transmitted from one generation to the next. (pp. 15, 789)
debriefing — the postexperimental explanation of a study, including its purpose and any deceptions, to its participants. (p. 62)
deep processing — encoding semantically, based on the meaning of the words; tends to yield the best retention. (p. 335)
defense mechanisms — in psychoanalytic theory, the ego’s protective methods of reducing anxiety by unconsciously distorting reality. (p. 581)
deindividuation — the loss of self-awareness and self-restraint occurring in group situations that foster arousal and anonymity. (p. 786)
déjà vu — that eerie sense that “I’ve experienced this before.” Cues from the current situation may unconsciously trigger retrieval of an earlier experience. (p. 358)
delta waves — the large, slow brain waves associated with the deep sleep of NREM-3. (p. 234)
delusion — a false belief, often of persecution or grandeur, that may accompany psychotic disorders. (p. 699)
dendrites — a neuron’s often bushy, branching extensions that receive and integrate messages, conducting impulses toward the cell body. (p. 82)
dependent variable — in an experiment, the outcome that is measured; the variable that may change when the independent variable is manipulated. (p. 56)
depressants — drugs (such as alcohol, barbiturates, and opiates) that reduce neural activity and slow body functions. (p. 255)
depth perception — the ability to see objects in three dimensions although the images that strike the retina are two-dimensional; allows us to judge distance. (p. 189)
descriptive statistics — numerical data used to measure and describe characteristics of groups. Includes measures of central tendency and measures of variation. (p. 66)
developmental psychology — a branch of psychology that studies physical, cognitive, and social change throughout the life span. (pp. 24, 486)
difference threshold — the minimum difference between two stimuli required for detection 50 percent of the time. We experience the difference threshold as a just noticeable difference (or jnd). (p. 163)
discrimination — (1) in classical conditioning, the learned ability to distinguish between a conditioned stimulus and similar stimuli that do not signal an unconditioned stimulus. (In operant conditioning, the ability to distinguish responses that are reinforced from similar responses that are not reinforced.) (2) in social psychology, unjustifiable negative behavior toward a group and its members. (pp. 277, 792)
discriminative stimulus — in operant conditioning, a stimulus that elicits a response after association with reinforcement (in contrast to related stimuli not associated with reinforcement). (p. 285)
dissociation — a split in consciousness, which allows some thoughts and behaviors to occur simultaneously with others. (p. 227)
dissociative disorders — controversial, rare disorders in which conscious awareness becomes separated (dissociated) from previous memories, thoughts, and feelings. (p. 708)
dissociative identity disorder (DID) — a rare dissociative disorder in which a person exhibits two or more distinct and alternating personalities. (Formerly called multiple personality disorder.) (p. 708)
divergent thinking — expanding the number of possible problem solutions; creative thinking that diverges in different directions. (p. 366)
DNA (deoxyribonucleic acid) — a complex molecule containing the genetic information that makes up the chromosomes. (p. 130)
double-blind procedure — an experimental procedure in which both the research participants and the research staff are ignorant (blind) about whether the research participants have received the treatment or a placebo. Commonly used in drug-evaluation studies. (p. 55)
Down syndrome — a condition of mild to severe intellectual disability and associated physical disorders caused by an extra copy of chromosome 21. (p. 644)
dream — a sequence of images, emotions, and thoughts passing through a sleeping person’s mind. (p. 247)
drive-reduction theory — the idea that a physiological need creates an aroused state (a drive) that motivates an organism to satisfy the need. (p. 403)
DSM-5 — the American Psychiatric Association’s Diagnostic and Statistical Manual of Mental Disorders, Fifth Edition; a widely used system for classifying psychological disorders. (p. 669)
dual processing — the principle that information is often simultaneously processed on separate conscious and unconscious tracks. (p. 125)
echoic memory — a momentary sensory memory of auditory stimuli; if attention is elsewhere, sounds and words can still be recalled within 3 or 4 seconds. (p. 332)
eclectic approach — an approach to psychotherapy that uses techniques from various forms of therapy. (p. 723)
Ecstasy (MDMA) — a synthetic stimulant and mild hallucinogen. Produces euphoria and social intimacy, but with short-term health risks and longer-term harm to serotonin-producing neurons and to mood and cognition. (p. 261)
educational psychology — the study of how psychological processes affect and can enhance teaching and learning. (p. 24)
EEG (electroencephalogram) — an amplified recording of the waves of electrical activity sweeping across the brain’s surface. These waves are measured by electrodes placed on the scalp. (p. 99)
effortful processing — encoding that requires attention and conscious effort. (p. 330)
ego — the largely conscious, “executive” part of personality that, according to Freud, mediates among the demands of the id, superego, and reality. The ego operates on the reality principle, satisfying the id’s desires in ways that will realistically bring pleasure rather than pain. (p. 580)
egocentrism — in Piaget’s theory, the preoperational child’s difficulty taking another’s point of view. (p. 501)
electroconvulsive therapy (ECT) — a biomedical therapy for severely depressed patients in which a brief electric current is sent through the brain of an anesthetized patient. (p. 756)
embodied cognition — the influence of bodily sensations, gestures, and other states on cognitive preferences and judgments. (p. 214)
embryo — the developing human organism from about 2 weeks after fertilization through the second month. (p. 489)
emerging adulthood — a period from about age 18 to the mid-twenties, when many in Western cultures are no longer adolescents but have not yet achieved full independence as adults. (p. 542)
emotion — a response of the whole organism, involving (1) physiological arousal, (2) expressive behaviors, and (3) conscious experience. (p. 433)
emotion-focused coping — attempting to alleviate stress by avoiding or ignoring a stressor and attending to emotional needs related to our stress reaction. (p. 306)
emotional intelligence — the ability to perceive, understand, manage, and use emotions. (p. 629)
empirically derived test — a test (such as the MMPI) created by selecting from a pool of items those that discriminate between groups. (p. 599)
empiricism — the idea that knowledge comes from experience, and that observation and experimentation enable scientific knowledge. (p. 7)
encoding specificity principle — the idea that cues and contexts specific to a particular memory will be most effective in helping us recall it. (p. 345)
encoding — the process of getting information into the memory system— for example, by extracting meaning. (p. 329)
endocrine — the body’s “slow” chemical communication system; a set of glands that secrete hormones into the bloodstream. (p. 95)
endorphins — [en-DOR-fins] “morphine within”—natural, opiate-like neurotransmitters linked to pain control and to pleasure. (p. 88)
environment — every nongenetic influence, from prenatal nutrition to the people and things around us. (p. 129)
epigenetics — “above” or “in addition to” (epi) genetics; the study of environmental influences on gene expression that occur without a DNA change. (pp. 137, 668)
episodic memory — explicit memory of personally experienced events; one of our two conscious memory systems (the other is semantic memory). (p. 340)
equity — a condition in which people receive from a relationship in proportion to what they give to it. (p. 813)
estrogens — sex hormones, such as estradiol, that contribute to female sex characteristics and are secreted in greater amounts by females than by males. Estrogen levels peak during ovulation. In nonhuman mammals, this promotes sexual receptivity. (p. 418)
evidence-based practice — clinical decision making that integrates the best available research with clinical expertise and patient characteristics and preferences. (p. 744)
evolutionary psychology — the study of the evolution of behavior and the mind, using principles of natural selection. (pp. 14, 141)
experiment — a research method in which an investigator manipulates one or more factors (independent variables) to observe the effect on some behavior or mental process (the dependent variable). By random assignment of participants, the experimenter aims to control other relevant factors. (p. 54)
experimental group — in an experiment, the group exposed to the treatment, that is, to one version of the independent variable. (p. 54)
explicit memory — retention of facts and experiences that one can consciously know and “declare.” (Also called declarative memory.) (p. 330)
exposure therapies — behavioral techniques, such as systematic desensitization and virtual reality exposure therapy, that treat anxieties by exposing people (in imaginary or actual situations) to the things they fear and avoid. (p. 730)
external locus of control — the perception that chance or outside forces beyond our personal control determine our fate. (p. 309)
extinction — the diminishing of a conditioned response; occurs in classical conditioning when an unconditioned stimulus (US) does not follow a conditioned stimulus (CS); occurs in operant conditioning when a response is no longer reinforced. (p. 276)
extrasensory perception (ESP) — the controversial claim that perception can occur apart from sensory input; includes telepathy, clairvoyance, and precognition. (p. 172)
extrinsic motivation — a desire to perform a behavior to receive promised rewards or avoid threatened punishment. (p. 305)
facial feedback effect — the tendency of facial muscle states to trigger corresponding feelings such as fear, anger, or happiness. (p. 447)
factor analysis — a statistical procedure that identifies clusters of related items (called factors) on a test; used to identify different dimensions of performance that underlie a person’s total score. (p. 626)
family therapy — therapy that treats people in the context of their family system. Views an individual’s unwanted behaviors as influenced by, or directed at, other family members. (p. 737)
feature detectors — nerve cells in the brain’s visual cortex that respond to specific features of the stimulus, such as shape, angle, or movement. (p. 183)
feel-good, do-good phenomenon — people’s tendency to be helpful when in a good mood. (p. 473)
fetal alcohol syndrome (FAS) — physical and cognitive abnormalities in children caused by a pregnant woman’s heavy drinking. In severe cases, signs include a small, out-of-proportion head and abnormal facial features. (p. 490)
fetus — the developing human organism from 9 weeks after conception to birth. (p. 489)
figure-ground — the organization of the visual field into objects (the figures) that stand out from their surroundings (the ground). (p. 187)
fixation — (1) in cognition, the inability to see a problem from a new perspective; an obstacle to problem solving. (2) in personality theory, according to Freud, a lingering focus of pleasure-seeking energies at an earlier psychosexual stage, in which conflicts were unresolved. (pp. 371, 581)
fixed-interval schedule — in operant conditioning, a reinforcement schedule that reinforces a response only after a specified time has elapsed. (p. 288)
fixed-ratio schedule — in operant conditioning, a reinforcement schedule that reinforces a response only after a specified number of responses. (p. 288)
flashbulb memory — a clear, sustained memory of an emotionally significant moment or event. (p. 342)
fluid intelligence — our ability to reason speedily and abstractly; tends to decrease with age, especially during late adulthood. (p. 640)
fMRI (functional MRI) — a technique for revealing bloodflow and, therefore, brain activity by comparing successive MRI scans. fMRI scans show brain function as well as structure. (p. 100)
foot-in-the-door phenomenon — the tendency for people who have first agreed to a small request to comply later with a larger request. (p. 771)
formal operational stage — in Piaget’s theory, the stage of cognitive development (normally beginning about age 12) during which people begin to think logically about abstract concepts. (p. 502)
fovea — the central focal point in the retina, around which the eye’s cones cluster. (p. 179)
framing — the way an issue is posed; how an issue is worded can significantly affect decisions and judgments. (p. 376)
fraternal (dizygotic) twins — develop from separate fertilized eggs. They are genetically no closer than ordinary brothers and sisters, but they share a prenatal environment. (p. 132)
free association — in psychoanalysis, a method of exploring the unconscious in which the person relaxes and says whatever comes to mind, no matter how trivial or embarrassing. (p. 579)
frequency — the number of complete wavelengths that pass a point in a given time (for example, per second). (p. 198)
frequency theory — in hearing, the theory that the rate of nerve impulses traveling up the auditory nerve matches the frequency of a tone, thus enabling us to sense its pitch. (Also called temporal theory.) (p. 202)
frontal lobes — the portion of the cerebral cortex lying just behind the forehead; involved in speaking and muscle movements and in making plans and judgments. (p. 109)
frustration-aggression principle — the principle that frustration—the blocking of an attempt to achieve some goal—creates anger, which can generate aggression. (p. 803)
functionalism — an early school of thought promoted by James and influenced by Darwin; explored how mental and behavioral processes function—how they enable the organism to adapt, survive, and flourish. (p. 8)
fundamental attribution error — the tendency for observers, when analyzing others’ behavior, to underestimate the impact of the situation and to overestimate the impact of personal disposition. (p. 768)
gate-control theory — the theory that the spinal cord contains a neurological “gate” that blocks pain signals or allows them to pass on to the brain. The “gate” is opened by the activity of pain signals traveling up small nerve fibers and is closed by activity in larger fibers or by information coming from the brain. (p. 207)
gender identity — our sense of being male, female, or some combination of the two. (p. 525)
gender — in psychology, the socially influenced characteristics by which people define boy, girl, man, and woman. (p. 520)
gender role — a set of expected behaviors, attitudes, and traits for males or for females. (p. 525)
gender typing — the acquisition of a traditional masculine or feminine role. (p. 525)
general adaptation syndrome (GAS) — Selye’s concept of the body’s adaptive response to stress in three phases—alarm, resistance, exhaustion. (p. 454)
general intelligence (g) — according to Spearman and others, underlies all mental abilities and is therefore measured by every task on an intelligence test. (p. 626)
generalization — the tendency, once a response has been conditioned, for stimuli similar to the conditioned stimulus to elicit similar responses. (In operant conditioning, generalization occurs when responses learned in one situation occur in other, similar situations.) (p. 276)
generalized anxiety disorder — an anxiety disorder in which a person is continually tense, apprehensive, and in a state of autonomic nervous system arousal. (p. 677)
genes — the biochemical units of heredity that make up the chromosomes; segments of DNA capable of synthesizing proteins. (p. 130)
genome — the complete instructions for making an organism, consisting of all the genetic material in that organism’s chromosomes. (p. 130)
gestalt — an organized whole. Gestalt psychologists emphasized our tendency to integrate pieces of information into meaningful wholes. (p. 187)
glial cells (glia) — cells in the nervous system that support, nourish, and protect neurons; they also play a role in learning, thinking, and memory. (p. 82)
glucose — the form of sugar that circulates in the blood and provides the major source of energy for body tissues. When its level is low, we feel hunger. (p. 409)
grammar — in a language, a system of rules that enables us to communicate with and understand others. Semantics is the language’s set of rules for deriving meaning from sounds, and syntax is its set of rules for combining words into grammatically sensible sentences. (p. 382)
GRIT — Graduated and Reciprocated Initiatives in Tension- Reduction—a strategy designed to decrease international tensions. (p. 822)
grit — in psychology, passion and perseverance in the pursuit of long-term goals. (pp. 429, 629)
group polarization — the enhancement of a group’s prevailing inclinations through discussion within the group. (p. 787)
group therapy — therapy conducted with groups rather than individuals, providing benefits from group interaction. (p. 737)
grouping — the perceptual tendency to organize stimuli into coherent groups. (p. 188)
groupthink — the mode of thinking that occurs when the desire for harmony in a decision-making group overrides a realistic appraisal of alternatives. (p. 788)
habituation — decreasing responsiveness with repeated exposure to a stimulus. (pp. 271, 491)
hallucinations — false sensory experiences, such as seeing something in the absence of an external visual stimulus. (pp. 233, 699)
hallucinogens — psychedelic (“mind-manifesting”) drugs, such as LSD, that distort perceptions and evoke sensory images in the absence of sensory input. (p. 261)
health psychology — a subfield of psychology that provides psychology’s contribution to behavioral medicine. (p. 456)
heredity — the genetic transfer of characteristics from parents to offspring. (p. 129)
heritability — the proportion of variation among individuals in a group that we can attribute to genes. The heritability of a trait may vary, depending on the range of populations and environments studied. (pp. 135, 647)
heuristic — a simple thinking strategy that often allows us to make judgments and solve problems efficiently; usually speedier but also more errorprone than an algorithm. (p. 370)
hierarchy of needs — Maslow’s pyramid of human needs, beginning at the base with physiological needs that must first be satisfied before higher-level safety needs and then psychological needs become active. (pp. 405, 591)
higher-order conditioning — a procedure in which the conditioned stimulus in one conditioning experience is paired with a new neutral stimulus, creating a second (often weaker) conditioned stimulus. For example, an animal that has learned that a tone predicts food might then learn that a light predicts the tone and begin responding to the light alone. (Also called second-order conditioning.) (p. 276)
hindsight bias — the tendency to believe, after learning an outcome, that one would have foreseen it. (Also known as the I-knew-it-all-along phenomenon.) (p. 38)
hippocampus — a neural center located in the limbic system; helps process for storage explicit (conscious) memories of facts and events. (pp. 106, 340)
histogram — a bar graph depicting a frequency distribution. (p. 66)
homeostasis — a tendency to maintain a balanced or constant internal state; the regulation of any aspect of body chemistry, such as blood glucose, around a particular level. (p. 403)
hormones — chemical messengers that are manufactured by the endocrine glands, travel through the bloodstream, and affect other tissues. (p. 95)
hue — the dimension of color that is determined by the wavelength of light; what we know as the color names blue, green, and so forth. (p. 177)
human factors psychology — a field of psychology allied with I/O psychology that explores how people and machines interact and how machines and physical environments can be made safe and easy to use. (p. 24)
humanistic psychology — a historically significant perspective that emphasized human growth potential. (p. 11)
humanistic theories — theories that view personality with a focus on the potential for healthy personal growth. (p. 591)
hypnagogic sensations — bizarre experiences, such as jerking or a feeling of falling or floating weightlessly, while transitioning to sleep. (p. 233)
hypnosis — a social interaction in which one person (the hypnotist) suggests to another (the subject) that certain perceptions, feelings, thoughts, or behaviors will spontaneously occur. (p. 225)
hypothalamus — [hi-po-THAL-uh-muss] a neural structure lying below (hypo) the thalamus; it directs several maintenance activities (eating, drinking, body temperature), helps govern the endocrine system via the pituitary gland, and is linked to emotion and reward. (p. 104)
hypothesis — a testable prediction, often implied by a theory. (p. 42)
iconic memory — a momentary sensory memory of visual stimuli; a picture-image memory lasting no more than a few tenths of a second. (p. 332)
id — a reservoir of unconscious psychic energy that, according to Freud, strives to satisfy basic sexual and aggressive drives. The id operates on the pleasure principle, demanding immediate gratification. (p. 580)
identical (monozygotic) twins — develop from a single fertilized egg that splits in two, creating two genetically identical organisms. (p. 131)
identification — the process by which, according to Freud, children incorporate their parents’ values into their developing superegos. (p. 581)
identity — our sense of self; according to Erikson, the adolescent’s task is to solidify a sense of self by testing and integrating various roles. (p. 539)
illness anxiety disorder — a disorder related to somatic symptom disorder in which a person interprets normal physical sensations as symptoms of a disease. (Formerly called hypochondriasis.) (p. 707)
illusory correlation — perceiving a relationship where none exists, or perceiving a stronger-than-actual relationship. (p. 53)
implicit memory — retention of learned skills or classically conditioned associations independent of conscious recollection. (Also called nondeclarative memory.) (p. 331)
imprinting — the process by which certain animals form strong attachments during early life. (p. 510)
inattentional blindness — failing to see visible objects when our attention is directed elsewhere. (p. 160)
incentive — a positive or negative environmental stimulus that motivates behavior. (p. 403)
independent variable — in an experiment, the factor that is manipulated; the variable whose effect is being studied. (p. 55)
individualism — giving priority to one’s own goals over group goals and defining one’s identity in terms of personal attributes rather than group identifications. (p. 616)
industrial-organizational (I/O) psychology — the application of psychological concepts and methods to optimizing human behavior in workplaces. (p. 24)
inferential statistics — numerical data that allow one to generalize—to infer from sample data the probability of something being true of a population. (p. 70)
informational social influence — influence resulting from one’s willingness to accept others’ opinions about reality. (p. 778)
informed consent — giving potential participants enough information about a study to enable them to choose whether they wish to participate. (p. 62)
ingroup — “us”—people with whom we share a common identity. (p. 796)
ingroup bias — the tendency to favor our own group. (p. 796)
inner ear — the innermost part of the ear, containing the cochlea, semicircular canals, and vestibular sacs. (p. 199)
insecure attachment — demonstrated by infants who display either a clinging, anxious attachment or an avoidant attachment that resists closeness. (p. 511)
insight — a sudden realization of a problem’s solution; contrasts with strategy-based solutions. (pp. 304, 370)
insight therapies — therapies that aim to improve psychological functioning by increasing a person’s awareness of underlying motives and defenses. (p. 725)
insomnia — recurring problems in falling or staying asleep. (p. 244)
instinct — a complex behavior that is rigidly patterned throughout a species and is unlearned. (p. 402)
instinctive drift — the tendency of learned behavior to gradually revert to biologically predisposed patterns. (p. 303)
intellectual disability — a condition of limited mental ability, indicated by an intelligence test score of 70 or below and difficulty adapting to the demands of life. (Formerly referred to as mental retardation.) (p. 644)
intelligence quotient (IQ) — defined originally as the ratio of mental age (ma) to chronological age (ca) multiplied by 100 (thus, IQ = ma/ca × 100). On contemporary intelligence tests, the average performance for a given age is assigned a score of 100. (p. 634)
intelligence test — a method for assessing an individual’s mental aptitudes and comparing them with those of others, using numerical scores. (p. 632)
intelligence — the ability to learn from experience, solve problems, and use knowledge to adapt to new situations. (p. 626)
intensity — the amount of energy in a light wave or sound wave, which influences what we perceive as brightness or loudness. Intensity is determined by the wave’s amplitude (height). (p. 177)
interaction — the interplay that occurs when the effect of one factor (such as environment) depends on another factor (such as heredity). (p. 137)
internal locus of control — the perception that we control our own fate. (p. 309)
interneurons — neurons within the brain and spinal cord; they communicate internally and process information between the sensory inputs and motor outputs. (p. 93)
interpretation — in psychoanalysis, the analyst’s noting supposed dream meanings, resistances, and other significant behaviors and events in order to promote insight. (p. 723)
intersex — a condition present at birth due to unusual combinations of male and female chromosomes, hormones, and anatomy; possessing biological sexual characteristics of both sexes. (p. 547)
intimacy — in Erikson’s theory, the ability to form close, loving relationships; a primary developmental task in young adulthood. (p. 540)
intrinsic motivation — a desire to perform a behavior effectively for its own sake. (p. 305)
introspection — the process of looking inward in an attempt to directly observe one’s own psychological processes. (p. 8)
intuition — an effortless, immediate, automatic feeling or thought, as contrasted with explicit, conscious reasoning. (p. 372)
iris — a ring of muscle tissue that forms the colored portion of the eye around the pupil and controls the size of the pupil opening. (p. 177)
James-Lange theory — the theory that our experience of emotion is our awareness of our physiological responses to an emotion-arousing stimulus: stimulus S arousal S emotion. (p. 433)
just-world phenomenon — the tendency for people to believe the world is just and that people therefore get what they deserve and deserve what they get. (p. 796)
kinesthesia — [kin-ehs-THEE-zhuh] our movement sense—our system for sensing the position and movement of individual body arts. (p. 213)
language — our spoken, written, or signed words and the ways we combine them to communicate meaning. (p. 381)
latent content — according to Freud, the underlying meaning of a dream (as distinct from its manifest content). (p. 248)
latent learning — learning that occurs but is not apparent until there is an incentive to demonstrate it. (p. 304)
law of effect — Thorndike’s principle that behaviors followed by favorable consequences become more likely, and that behaviors followed by unfavorable consequences become less likely. (p. 283)
learned helplessness — the hopelessness and passive resignation an animal or person learns when unable to avoid repeated aversive events. (p. 307)
learning — the process of acquiring through experience new and relatively enduring information or behaviors. (p. 270)
lens — the transparent structure behind the pupil that changes shape to help focus images on the retina. (p. 177)
lesion — [LEE-zhuhn] tissue destruction. A brain lesion is a naturally or experimentally caused destruction of brain tissue. (p. 98)
limbic system — neural system (including the amygdala, hypothalamus, and hippocampus) located below the cerebral hemispheres; associated with emotions and drives. (p. 104)
linguistic determinism — the strong form of Whorf’s hypothesis—that language controls the way we think and interpret the world around us. (p. 389)
linguistic influence — the weaker form of “linguistic relativity”—the idea that language affects thought (thus our thinking and world view is “relative to” our cultural language). (p. 389)
lobotomy — a psychosurgical procedure once used to calm uncontrollably emotional or violent patients. The procedure cut the nerves connecting the frontal lobes to the emotion-controlling centers of the inner brain. (p. 758)
long-term memory — the relatively permanent and limitless storehouse of the memory system. Includes knowledge, skills, and experiences. (p. 329)
long-term potentiation (LTP) — an increase in a cell’s firing potential after brief, rapid stimulation; a neural basis for learning and memory. (p. 342)
longitudinal study — research that follows and retests the same people over time. (pp. 563, 640)
LSD — a powerful hallucinogenic drug; also known as acid (lysergic acid diethylamide). (p. 262)
major depressive disorder — a disorder in which a person experiences, in the absence of drugs or another medical condition, two or more weeks with five or more symptoms, at least one of which must be either (1) depressed mood or (2) loss of interest or pleasure. (p. 687)
mania — a hyperactive, wildly optimistic state in which dangerously poor judgment is common. (p. 687)
manifest content — according to Freud, the symbolic, remembered story line of a dream (as distinct from its latent, or hidden, content). (p. 248)
maturation — biological growth processes that enable orderly changes in behavior, relatively uninfluenced by experience. (p. 494)
mean — the arithmetic average of a distribution, obtained by adding the scores and then dividing by the number of scores. (p. 67)
median — the middle score in a distribution; half the scores are above it and half are below it. (p. 67)
medical model — the concept that diseases, in this case psychological disorders, have physical causes that can be diagnosed, treated, and, in most cases, cured, often through treatment in a hospital. (p. 667)
medulla — [muh-DUL-uh] the base of the brainstem; controls heartbeat and breathing. (p. 102)
MEG (magnetoencephalography) — a brain imaging technique that measures magnetic fields from the brain’s natural electrical activity. (p. 99)
memory consolidation — the neural storage of a long-term memory. (p. 340)
memory — the persistence of learning over time through the encoding, storage, and retrieval of information. (p. 326)
menarche — [meh-NAR-key] the first menstrual period. (p. 547)
menopause — the time of natural cessation of menstruation; also refers to the biological changes a woman experiences as her ability to reproduce declines. (p. 558)
mental age — a measure of intelligence test performance devised by Binet; the level of performance typically associated with children of a certain chronological age. Thus, a child who does as well as an average 8-year-old is said to have a mental age of 8. (p. 633)
mental set — a tendency to approach a problem in one particular way, often a way that has been successful in the past. (p. 371)
mere exposure effect — the phenomenon that repeated exposure to novel stimuli increases liking of them. (p. 808)
meta-analysis — a procedure for statistically combining the results of many different research studies. (p. 743)
methamphetamine — a powerfully addictive drug that stimulates the central nervous system, with accelerated body functions and associated energy and mood changes; over time, appears to reduce baseline dopamine levels. (p. 260)
middle ear — the chamber between the eardrum and cochlea containing three tiny bones (hammer, anvil, and stirrup) that concentrate the vibrations of the eardrum on the cochlea’s oval window. (p. 199)
mindfulness meditation — a reflective practice in which people attend to current experiences in a nonjudgmental and accepting manner. (p. 470)
Minnesota Multiphasic Personality Inventory (MMPI) — the most widely researched and clinically used of all personality tests. Originally developed to identify emotional disorders (still considered its most appropriate use), this test is now used for many other screening purposes. (p. 598)
mirror neurons — frontal lobe neurons that some scientists believe fire when we perform certain actions or observe another doing so. The brain’s mirroring of another’s action may enable imitation and empathy. (p. 313)
mirror-image perceptions — mutual views often held by conflicting people, as when each side sees itself as ethical and peaceful and views the other side as evil and aggressive. (p. 820)
misinformation effect — occurs when misleading information has distorted one’s memory of an event. (p. 357)
mnemonics — [nih-MON-iks] memory aids, especially those techniques that use vivid imagery and organizational devices. (p. 333)
mode — the most frequently occurring score(s) in a distribution. (p. 67)
modeling — the process of observing and imitating a specific behavior. (p. 312)
molecular behavior genetics — the study of how the structure and function of genes interact with our environment to influence behavior. (p. 137)
molecular genetics — the subfield of biology that studies the molecular structure and function of genes. (p. 137)
monocular cue — a depth cue, such as interposition or linear perspective, available to either eye alone. (p. 190)
mood-congruent memory — the tendency to recall experiences that are consistent with one’s current good or bad mood. (p. 346)
morpheme — in a language, the smallest unit that carries meaning; may be a word or a part of a word (such as a prefix). (p. 382)
motivation — a need or desire that energizes and directs behavior. (p. 402)
motor (efferent) neurons — neurons that carry outgoing information from the brain and spinal cord to the muscles and glands. (p. 93)
motor cortex — an area at the rear of the frontal lobes that controls voluntary movements. (p. 110)
MRI (magnetic resonance imaging) — a technique that uses magnetic fields and radio waves to produce computer-generated images of soft tissue. MRI scans show brain anatomy. (p. 99)
mutation — a random error in gene replication that leads to a change. (p. 142)
myelin — a fatty tissue layer segmentally encasing the axons of some neurons; enables vastly greater transmission speed as neural impulses hop from one node to the next. (p. 82)
narcissism — excessive self-love and self-absorption. (pp. 427, 615)
narcolepsy — a sleep disorder characterized by uncontrollable sleep attacks. The sufferer may lapse directly into REM sleep, often at inopportune times. (p. 245)
natural selection — the principle that inherited traits that better enable an organism to survive and reproduce in a particular environment will (in competition with other trait variations) most likely be passed on to succeeding generations. (pp. 14, 141)
naturalistic observation — a descriptive technique of observing and recording behavior in naturally occurring situations without trying to manipulate or control the situation. (p. 45)
nature–nurture issue — the longstanding controversy over the relative contributions that genes and experience make to the development of psychological traits and behaviors. Today’s science sees traits and behaviors arising from the interaction of nature and nurture. (p. 14)
near-death experience — an altered state of consciousness reported after a close brush with death (such as cardiac arrest); often similar to drug-induced hallucinations. (p. 262)
negative reinforcement — increasing behaviors by stopping or reducing aversive stimuli. A negative reinforcer is any stimulus that, when removed after a response, strengthens the response. (Note: Negative reinforcement is not punishment.) (p. 285)
nerves — bundled axons that form neural cables connecting the central nervous system with muscles, glands, and sense organs. (p. 92)
nervous system — the body’s speedy, electrochemical communication network, consisting of all the nerve cells of the peripheral and central nervous systems. (p. 91)
neurocognitive disorders (NCDs) — acquired (not lifelong) disorders marked by cognitive deficits; often related to Alzheimer’s disease, brain injury or disease, or substance abuse. In older adults, neurocognitive disorders were formerly called dementia. (p. 563)
neurogenesis — the formation of new neurons. (p. 117)
neuron — a nerve cell; the basic building block of the nervous system. (p. 81)
neurotransmitters — chemical messengers that cross the synaptic gaps between neurons. When released by the sending neuron, neurotransmitters travel across the synapse and bind to receptor sites on the receiving neuron, thereby influencing whether that neuron will generate a neural impulse. (p. 85)
neutral stimulus (NS) — in classical conditioning, a stimulus that elicits no response before conditioning. (p. 273)
nicotine — a stimulating and highly addictive psychoactive drug in tobacco. (p. 258)
night terrors — a sleep disorder characterized by high arousal and an appearance of being terrified; unlike nightmares, night terrors occur during NREM-3 sleep, within two or three hours of falling asleep, and are seldom remembered. (p. 246)
normal curve — (normal distribution) a symmetrical, bell-shaped curve that describes the distribution of many types of data; most scores fall near the mean (about 68 percent fall within one standard deviation of it) and fewer and fewer near the extremes. (pp. 68, 635)
normative social influence — influence resulting from a person’s desire to gain approval or avoid disapproval. (p. 777)
norms — understood rules for accepted and expected behavior. Norms prescribe “proper” behavior. (p. 775)
NREM sleep — non-rapid eye movement sleep; encompasses all sleep stages except for REM sleep. (p. 233)
obesity — defined as a body mass index (BMI) measurement of 30 or higher. (Overweight individuals have a BMI of 25 or higher.) (p. 414)
object permanence — the awareness that things continue to exist even when not perceived. (p. 499)
observational learning — learning by observing others. (Also called social learning.) (p. 312)
obsessive-compulsive disorder (OCD) — a disorder characterized by unwanted repetitive thoughts (obsessions), actions (compulsions), or both. (p. 679)
occipital — the portion of the cerebral cortex lying at the back of the head; includes areas that receive information from the visual fields. (p. 110)
Oedipus — according to Freud, a boy’s sexual desires toward his mother and feelings of jealousy and hatred for the rival father. (p. 580)
olfaction — the sense of smell. (p. 211)
one-word stage — the stage in speech development, from about age 1 to 2, during which a child speaks mostly in single words. (p. 384)
operant behavior — behavior that operates on the environment, producing consequences. (p. 271)
operant chamber — in operant conditioning research, a chamber (also known as a Skinner box) containing a bar or key that an animal can manipulate to obtain a food or water reinforcer; attached devices record the animal’s rate of bar pressing or key pecking. (p. 284)
operant conditioning — a type of learning in which a behavior becomes more likely to recur if followed by a reinforcer or less likely to recur if followed by a punisher. (p. 283)
operational definition — a carefully worded statement of the exact procedures (operations) used in a research study. For example, human intelligence may be operationally defined as what an intelligence test measures. (p. 42)
opiates — opium and its derivatives, such as morphine and heroin; depress neural activity, temporarily lessening pain and anxiety. (p. 257)
opponent-process theory — the theory that opposing retinal processes (red-green, blue-yellow, white-black) enable color vision. For example, some cells are stimulated by green and inhibited by red; others are stimulated by red and inhibited by green. (p. 182)
optic nerve — the nerve that carries neural impulses from the eye to the brain. (p. 178)
ostracism — deliberate social exclusion of individuals or groups. (p. 425)
other-race effect — the tendency to recall faces of one’s own race more accurately than faces of other races. Also called the cross-race effect and the own-race bias. (p. 797)
outgroup — “them”—those perceived as different or apart from our ingroup. (p. 796)
overconfidence — the tendency to be more confident than correct—to overestimate the accuracy of our beliefs and judgments. (p. 375)
panic disorder — an anxiety disorder marked by unpredictable, minuteslong episodes of intense dread in which a person may experience terror and accompanying chest pain, choking, or other frightening sensations; often followed by worry over a possible next attack. (p. 678)
parallel processing — processing many aspects of a problem simultaneously; the brain’s natural mode of information processing for many functions. (pp. 126, 183, 329)
parapsychology — the study of paranormal phenomena, including ESP and psychokinesis. (p. 172)
parasympathetic nervous system — the division of the autonomic nervous system that calms the body, conserving its energy. (p. 93)
parietal — the portion of the cerebral cortex lying at the top of the head and toward the rear; receives sensory input for touch and body position. (p. 109)
partial (intermittent) reinforcement schedule — reinforcing a response only part of the time; results in slower acquisition of a response but much greater resistance to extinction than does continuous reinforcement. (p. 287)
passionate love — an aroused state of intense positive absorption in another, usually present at the beginning of a romantic relationship. (p. 812)
perception — the process of organizing and interpreting sensory information, enabling us to recognize meaningful objects and events. (p. 158)
perceptual adaptation — the ability to adjust to changed sensory input, including an artificially displaced or even inverted visual field. (p. 195)
perceptual constancy — perceiving objects as unchanging (having consistent color, brightness, shape, and size) even as illumination and retinal images change. (p. 191)
perceptual set — a mental predisposition to perceive one thing and not another. (p. 169)
peripheral nervous system (PNS) — the sensory and motor neurons that connect the central nervous system (CNS) to the rest of the body. (p. 92)
peripheral route persuasion — occurs when people are influenced by incidental cues, such as a speaker’s attractiveness. (p. 771)
personal control — our sense of controlling our environment rather than feeling helpless. (p. 306)
personality — an individual’s characteristic pattern of thinking, feeling, and acting. (p. 578)
personality disorders — inflexible and enduring behavior patterns that impair social functioning. (p. 710)
personality inventory — a questionnaire (often with true-false or agree-disagree items) on which people respond to items designed to gauge a wide range of feelings and behaviors; used to assess selected personality traits. (p. 598)
personality psychology — the study of individuals’ characteristic patterns of thinking, feeling, and acting. (p. 24)
PET (positron emission tomography) scan — a visual display of brain activity that detects where a radioactive form of glucose goes while the brain performs a given task. (p. 99)
phi phenomenon — an illusion of movement created when two or more adjacent lights blink on and off in quick succession. (p. 190)
phobia — an anxiety disorder marked by a persistent, irrational fear and avoidance of a specific object, activity, or situation. (p. 679)
phoneme — in a language, the smallest distinctive sound unit. (p. 381)
physiological need — a basic bodily requirement. (p. 403)
pitch — a tone’s experienced highness or lowness; depends on frequency. (p. 198)
pituitary gland — the endocrine system’s most influential gland. Under the influence of the hypothalamus, the pituitary regulates growth and controls other endocrine glands. (p. 96)
place theory — in hearing, the theory that links the pitch we hear with the place where the cochlea’s membrane is stimulated. (p. 202)
placebo — experimental results caused by expectations alone; any effect on behavior caused by the administration of an inert substance or condition, which the recipient assumes is an active agent. (p. 55)
plasticity — the brain’s ability to change, especially during childhood, by reorganizing after damage or by building new pathways based on experience. (p. 116)
polygraph — a machine used in attempts to detect lies that measures several of the physiological responses (such as perspiration, heart rate, and breathing changes) accompanying emotion. (p. 439)
population — all those in a group being studied, from which samples may be drawn. (Note: Except for national studies, this does not refer to a country’s whole population.) (p. 47)
positive psychology — the scientific study of human flourishing, with the goals of discovering and promoting strengths and virtues that help individuals and communities to thrive. (pp. 16, 473)
positive reinforcement — increasing behaviors by presenting positive reinforcers. A positive reinforcer is any stimulus that, when presented after a response, strengthens the response. (p. 285)
posthypnotic suggestion — a suggestion, made during a hypnosis session, to be carried out after the subject is no longer hypnotized; used by some clinicians to help control undesired symptoms and behaviors. (p. 226)
posttraumatic growth — positive psychological changes as a result of struggling with extremely challenging circumstances and life crises. (p. 760)
posttraumatic stress disorder (PTSD) — a disorder characterized by haunting memories, nightmares, hypervigilance, social withdrawal, jumpy anxiety, numbness of feeling, and/or insomnia that lingers for four weeks or more after a traumatic experience. (p. 680)
predictive validity — the success with which a test predicts the behavior it is designed to predict; it is assessed by computing the correlation between test scores and the criterion behavior. (Also called criterion-related validity.) (p. 637)
prejudice — an unjustifiable (and usually negative) attitude toward a group and its members. Prejudice generally involves stereotyped beliefs, negative feelings, and a predisposition to discriminatory action. (p. 792)
preoperational stage — in Piaget’s theory, the stage (from about 2 to 6 or 7 years of age) during which a child learns to use language but does not yet comprehend the mental operations of concrete logic. (p. 500)
preparedness — a biological predisposition to learn associations, such as between taste and nausea, that have survival value. (p. 300)
primary reinforcer — an innately reinforcing stimulus, such as one that satisfies a biological need. (p. 286)
primary sex characteristics — the body structures (ovaries, testes, and external genitalia) that make sexual reproduction possible. (p. 546)
priming — the activation, often unconsciously, of certain associations, thus predisposing one’s perception, memory, or response. (pp. 165, 345)
proactive interference — the forward-acting disruptive effect of older learning on the recall of new information. (p. 354)
problem-focused coping — attempting to alleviate stress directly—by changing the stressor or the way we interact with that stressor. (p. 306)
projective test — a personality test, such as the Rorschach, that provides ambiguous images designed to trigger projection of one’s inner dynamics. (p. 584)
prosocial behavior — positive, constructive, helpful behavior. The opposite of antisocial behavior. (p. 315)
prototype — a mental image or best example of a category. Matching new items to a prototype provides a quick and easy method for sorting items into categories (as when comparing feathered creatures to a prototypical bird, such as a robin). (p. 365)
psychiatry — a branch of medicine dealing with psychological disorders; practiced by physicians who are licensed to provide medical (for example, drug) treatments as well as psychological therapy. (p. 25)
psychoactive drug — a chemical substance that alters perceptions and moods. (p. 253)
psychoanalysis — (1) Freud’s theory of personality that attributes thoughts and actions to unconscious motives and conflicts. (2) Sigmund Freud’s therapeutic technique used in treating psychological disorders. Freud believed the patient’s free associations, resistances, dreams, and transferences—and the therapist’s interpretations of them—released previously repressed feelings, allowing the patient to gain self-insight. (pp. 579, 723)
psychodynamic psychology — a branch of psychology that studies how unconscious drives and conflicts influence behavior and uses that information to treat people with psychological disorders. (p. 18)
psychodynamic theories — theories that view personality with a focus on the unconscious and the importance of childhood experiences. (p. 578)
psychodynamic therapy — therapy deriving from the psychoanalytic tradition; views individuals as responding to unconscious forces and childhood experiences, and seeks to enhance self-insight. (p. 724)
psychological disorder — a syndrome marked by a clinically significant disturbance in an individual’s cognition, emotion regulation, or behavior. (p. 666)
psychology — the science of behavior and mental processes. (p. 13)
psychometrics — the scientific study of the measurement of human abilities, attitudes, and traits. (p. 24)
psychoneuroimmunology — the study of how psychological, neural, and endocrine processes together affect the immune system and resulting health. (p. 456)
psychopharmacology — the study of the effects of drugs on mind and behavior. (p. 753)
psychophysics — the study of relationships between the physical characteristics of stimuli, such as their intensity, and our psychological experience of them. (p. 162)
psychosexual stages — the childhood stages of development (oral, anal, phallic, latency, genital) during which, according to Freud, the id’s pleasure-seeking energies focus on distinct erogenous zones. (p. 580)
psychosurgery — surgery that removes or destroys brain tissue in an effort to change behavior. (p. 758)
psychotherapy — treatment involving psychological techniques; consists of interactions between a trained therapist and someone seeking to overcome psychological difficulties or achieve personal growth. (p. 722)
psychotic disorders — a group of disorders marked by irrational ideas, distorted perceptions, and a loss of contact with reality. (p. 699)
puberty — the period of sexual maturation, during which a person becomes capable of reproducing. (p. 533)
punishment — an event that tends to decrease the behavior that it follows. (p. 289)
pupil — the adjustable opening in the center of the eye through which light enters. (p. 177)
random assignment — assigning participants to experimental and control groups by chance, thus minimizing preexisting differences between the different groups. (p. 54)
random sample — a sample that fairly represents a population because each member has an equal chance of inclusion. (p. 47)
range — the difference between the highest and lowest scores in a distribution. (p. 68)
rational-emotive behavior therapy (REBT) — a confrontational cognitive therapy, developed by Albert Ellis, that vigorously challenges people’s illogical, self-defeating attitudes and assumptions. (p. 733)
recall — a measure of memory in which the person must retrieve information learned earlier, as on a fill-in-the-blank test. (p. 327)
reciprocal determinism — the interacting influences of behavior, internal cognition, and environment. (p. 606)
reciprocity norm — an expectation that people will help, not hurt, those who have helped them. (p. 818)
recognition — a measure of memory in which the person identifies items previously learned, as on a multiple-choice test. (p. 327)
reconsolidation — a process in which previously stored memories, when retrieved, are potentially altered before being stored again. (p. 356)
reflex — a simple, automatic response to a sensory stimulus, such as the knee-jerk response. (p. 94)
refractory period — (1) in neural processing, a brief resting pause that occurs after a neuron has fired; subsequent action potentials cannot occur until the axon returns to its resting state. (2) in human sexuality, a resting period that occurs after orgasm, during which a person cannot achieve another orgasm. (pp. 83, 420)
regression toward the mean — the tendency for extreme or unusual scores or events to fall back (regress) toward the average. (p. 53)
reinforcement — in operant conditioning, any event that strengthens the behavior it follows. (p. 284)
reinforcement schedule — a pattern that defines how often a desired response will be reinforced. (p. 287)
relational aggression — an act of aggression (physical or verbal) intended to harm a person’s relationship or social standing. (p. 521)
relative deprivation — the perception that one is worse off relative to those with whom one compares oneself. (p. 476)
relearning — a measure of memory that assesses the amount of time saved when learning material again. (p. 327)
reliability — the extent to which a test yields consistent results, as assessed by the consistency of scores on two halves of the test, on alternative forms of the test, or on retesting. (p. 636)
REM rebound — the tendency for REM sleep to increase following REM sleep deprivation. (p. 251)
REM sleep — rapid eye movement sleep; a recurring sleep stage during which vivid dreams commonly occur. Also known as paradoxical sleep, because the muscles are relaxed (except for minor twitches) but other body systems are active. (p. 232)
repetitive transcranial magnetic stimulation (rTMS) — the application of repeated pulses of magnetic energy to the brain; used to stimulate or suppress brain activity. (p. 757)
replication — repeating the essence of a research study, usually with different participants in different situations, to see whether the basic finding can be reproduced. (p. 43)
representativeness heuristic — estimating the likelihood of events in terms of how well they seem to represent, or match, particular prototypes; may lead us to ignore other relevant information. (p. 372)
repression — in psychoanalytic theory, the basic defense mechanism that banishes from consciousness anxiety-arousing thoughts, feelings, and memories. (pp. 355, 581)
resilience — the personal strength that helps most people cope with stress and recover from adversity and even trauma. (p. 760)
resistance — in psychoanalysis, the blocking from consciousness of anxietyladen material. (p. 723)
respondent behavior — behavior that occurs as an automatic response to some stimulus. (p. 271)
reticular formation — a nerve network that travels through the brainstem into the thalamus and plays an important role in controlling arousal. (p. 102)
retina — the light-sensitive inner surface of the eye, containing the receptor rods and cones plus layers of neurons that begin the processing of visual information. (p. 177)
retinal disparity — a binocular cue for perceiving depth. By comparing retinal images from the two eyes, the brain computes distance—the greater the disparity (difference) between the two images, the closer the object. (p. 189)
retrieval — the process of getting information out of memory storage. (p. 329)
retroactive interference — the backward-acting disruptive effect of newer learning on the recall of old information. (p. 354)
retrograde amnesia — an inability to retrieve information from one’s past. (p. 351)
reuptake — a neurotransmitter’s reabsorption by the sending neuron. (p. 86)
rods — retinal receptors that detect black, white, and gray, and are sensitive to movement; necessary for peripheral and twilight vision, when cones don’t respond. (p. 178)
role — a set of expectations (norms) about a social position, defining how those in the position ought to behave. (pp. 525, 772)
Rorschach inkblot test — the most widely used projective test; a set of 10 inkblots, designed by Hermann Rorschach; seeks to identify people’s inner feelings by analyzing their interpretations of the blots. (p. 584)
rumination — compulsive fretting; overthinking our problems and their causes. (p. 693)
sampling bias — a flawed sampling process that produces an unrepresentative sample. (p. 47)
savant syndrome — a condition in which a person otherwise limited in mental ability has an exceptional specific skill, such as in computation or drawing. (p. 627)
scaffold — a framework that offers children temporary support as they develop higher levels of thinking. (p. 503)
scapegoat theory — the theory that prejudice offers an outlet for anger by providing someone to blame. (p. 797)
scatterplot — a graphed cluster of dots, each of which represents the values of two variables. The slope of the points suggests the direction of the relationship between the two variables. The amount of scatter suggests the strength of the correlation (little scatter indicates high correlation). (p. 51)
schema — a concept or framework that organizes and interprets information. (p. 498)
schizophrenia — a disorder characterized by delusions, hallucinations, disorganized speech, and/or diminished, inappropriate emotional expression. (p. 699)
secondary sex characteristics — nonreproductive sexual traits, such as female breasts and hips, male voice quality, and body hair. (p. 546)
secure attachment — demonstrated by infants who comfortably explore environments in the presence of their caregiver, show only temporary distress when the caregiver leaves, and find comfort in the caregiver’s return. (p. 511)
selective attention — the focusing of conscious awareness on a particular stimulus. (p. 159)
self — in contemporary psychology, assumed to be the center of personality, the organizer of our thoughts, feelings, and actions. (p. 611)
self-actualization — according to Maslow, one of the ultimate psychological needs that arises after basic physical and psychological needs are met and self-esteem is achieved; the motivation to fulfill one’s potential. (p. 591)
self-concept — all our thoughts and feelings about ourselves in answer to the question, “Who am I?” (pp. 515, 592)
self-control — the ability to control impulses and delay short-term gratification for greater long-term rewards. (p. 309)
self-disclosure — the act of revealing intimate aspects of ourselves to others. (p. 814)
self-efficacy — one’s sense of competence and effectiveness. (p. 612)
self-esteem — one’s feelings of high or low self-worth. (p. 612)
self-fulfilling prophecy — a belief that leads to its own fulfillment. (p. 820)
self-serving bias — a readiness to perceive oneself favorably. (p. 614)
self-transcendence — according to Maslow, the striving for identity, meaning, and purpose beyond the self. (p. 591)
semantic memory — explicit memory of facts and general knowledge; one of our two conscious memory systems (the other is episodic memory). (p. 340)
sensation — the process by which our sensory receptors and nervous system receive and represent stimulus energies from our environment. (p. 158)
sensorimotor stage — in Piaget’s theory, the stage (from birth to nearly 2 years of age) during which infants know the world mostly in terms of their sensory impressions and motor activities. (p. 499)
sensorineural hearing loss — hearing loss caused by damage to the cochlea’s receptor cells or to the auditory nerves; the most common form of hearing loss, also called nerve deafness. (p. 200)
sensory (afferent) neurons — neurons that carry incoming information from the body’s tissues and sensory receptors to the brain and spinal cord. (p. 93)
sensory adaptation — diminished sensitivity as a consequence of constant stimulation. (p. 165)
sensory interaction — the principle that one sense may influence another, as when the smell of food influences its taste. (p. 214)
sensory memory — the immediate, very brief recording of sensory information in the memory system. (p. 329)
sensory receptors — sensory nerve endings that respond to stimuli. (p. 158)
sequential processing — processing one aspect of a problem at a time; generally used to process new information or to solve difficult problems. (p. 126)
serial position effect — our tendency to recall best the last (recency effect) and first (primacy effect) items in a list. (p. 347)
set point — the point at which your “weight thermostat” may be set. When your body falls below this weight, increased hunger and a lowered metabolic rate may combine to restore lost weight. (p. 411)
sex — in psychology, the biologically influenced characteristics by which people define male and female. (p. 520)
sexual orientation — our enduring sexual attraction, usually toward members of our own sex (homosexual orientation) or the other sex (heterosexual orientation); variations include attraction toward both sexes (bisexual orientation). (p. 549)
sexual response cycle — the four stages of sexual responding described by Masters and Johnson—excitement, plateau, orgasm, and resolution. (p. 419)
shallow processing — encoding on a basic level, based on the structure or appearance of words. (p. 335)
shaping — an operant conditioning procedure in which reinforcers guide behavior toward closer and closer approximations of the desired behavior. (p. 284)
short-term memory — activated memory that holds a few items briefly, such as digits of a phone number while calling, before the information is stored or forgotten. (p. 329)
signal detection theory — a theory predicting how and when we detect the presence of a faint stimulus (signal) amid background stimulation (noise). Assumes there is no single absolute threshold and that detection depends partly on a person’s experience, expectations, motivation, and alertness. (p. 163)
skewed distribution — a representation of scores that lack symmetry around their average value. (p. 67)
sleep — a periodic, natural loss of consciousness — as distinct from unconsciousness resulting from a coma, general anesthesia, or hibernation. (Adapted from Dement, 1999.) (p. 231)
sleep apnea — a sleep disorder characterized by temporary cessations of breathing during sleep and repeated momentary awakenings. (p. 245)
social anxiety disorder — intense fear and avoidance of social situations. (Formerly called social phobia.) (p. 677)
social clock — the culturally preferred timing of social events such as marriage, parenthood, and retirement. (p. 565)
social exchange theory — the theory that our social behavior is an exchange process, the aim of which is to maximize benefits and minimize costs. (p. 818)
social facilitation — improved performance on simple or well-learned tasks in the presence of others. (p. 784)
social identity — the “we” aspect of our self-concept; the part of our answer to “Who am I?” that comes from our group memberships. (p. 539)
social learning theory — the theory that we learn social behavior by observing and imitating and by being rewarded or punished. (p. 525)
social loafing — the tendency for people in a group to exert less effort when pooling their efforts toward attaining a common goal than when individually accountable. (p. 785)
social psychology — the scientific study of how we think about, influence, and relate to one another. (pp. 24, 768)
social script — a culturally modeled guide for how to act in various situations. (pp. 146, 804)
social trap — a situation in which the conflicting parties, by each pursuing their self-interest rather than the good of the group, become caught in mutually destructive behavior. (p. 819)
social-cognitive perspective — views behavior as influenced by the interaction between people’s traits (including their thinking) and their social context. (p. 606)
social-cultural psychology — the study of how situations and cultures affect our behavior and thinking. (p. 18)
social-responsibility norm — an expectation that people will help those needing their help. (p. 819)
somatic nervous system — the division of the peripheral nervous system that controls the body’s skeletal muscles. Also called the skeletal nervous system. (p. 93)
somatic symptom disorder — a psychological disorder in which the symptoms take a somatic (bodily) form without apparent physical cause. (Formerly called somatoform disorder; see conversion disorder and illness anxiety disorder.) (p. 707)
somatosensory cortex — an area at the front of the parietal lobes that registers and processes body touch and movement sensations. (p. 113)
source amnesia — faulty memory for how, when, or where information was learned or imagined. (Also called source misattribution.) Source amnesia, along with the misinformation effect, is at the heart of many false memories. (p. 358)
spacing effect — the tendency for distributed study or practice to yield better long-term retention than is achieved through massed study or practice. (p. 334)
spermarche — [sper-MAR-key] the first ejaculation. (p. 547)
split brain — a condition resulting from surgery that isolates the brain’s two hemispheres by cutting the fibers (mainly those of the corpus callosum) connecting them. (p. 120)
spontaneous recovery — the reappearance, after a pause, of an extinguished conditioned response. (p. 276)
spotlight effect — overestimating others’ noticing and evaluating our appearance, performance, and blunders (as if we presume a spotlight shines on us). (p. 611)
SQ3R — a study method incorporating five steps: Survey, Question, Read, Retrieve, Review. (p. 20)
standard deviation — a computed measure of how much scores vary around the mean score. (p. 68)
standardization — defining uniform testing procedures and meaningful scores by comparison with the performance of a pretested group. (p. 635)
Stanford-Binet — the widely used American revision (by Terman at Stanford University) of Binet’s original intelligence test. (p. 634)
statistical significance — a statistical statement of how likely it is that an obtained result occurred by chance. (p. 71)
stereotype — a generalized (sometimes accurate but often overgeneralized) belief about a group of people. (p. 792)
stereotype threat — a self-confirming concern that one will be evaluated based on a negative stereotype. (p. 657)
stimulants — drugs (such as caffeine, nicotine, and the more powerful cocaine, amphetamines, methamphetamine, and Ecstasy) that excite neural activity and speed up body functions. (p. 257)
stimulus — any event or situation that evokes a response. (p. 271)
storage — the process of retaining encoded information over time. (p. 329)
strange situation — a procedure for studying child-caregiver attachment; a child is placed in an unfamiliar environment while their caregiver leaves and then returns, and the child’s reactions are observed. (p. 511)
stranger anxiety — the fear of strangers that infants commonly display, beginning by about 8 months of age. (p. 509)
stress — the process by which we perceive and respond to certain events, called stressors, that we appraise as threatening or challenging. (p. 450)
structuralism — an early school of thought promoted by Wundt and Titchener; used introspection to reveal the structure of the human mind. (p. 7)
subjective well-being — self-perceived happiness or satisfaction with life. Used along with measures of objective well-being (for example, physical and economic indicators) to evaluate people’s quality of life. (p. 473)
subliminal — below one’s absolute threshold for conscious awareness. (p. 163)
substance use disorder — a disorder characterized by continued substance craving and use despite significant life disruption and/or physical risk. (p. 253)
superego — the part of personality that, according to Freud, represents internalized ideals and provides standards for judgment (the conscience) and for future aspirations. (p. 580)
superordinate goals — shared goals that override differences among people and require their cooperation. (p. 821)
suprachiasmatic nucleus (SCN) — a pair of cell clusters in the hypothalamus that controls circadian rhythm. In response to light, the SCN causes the pineal gland to adjust melatonin production, thus modifying our feelings of sleepiness. (p. 235)
survey — a descriptive technique for obtaining the self-reported attitudes or behaviors of a particular group, usually by questioning a representative, random sample of the group. (p. 47)
sympathetic nervous system — the division of the autonomic nervous system that arouses the body, mobilizing its energy. (p. 93)
synapse — [SIN-aps] the junction between the axon tip of the sending neuron and the dendrite or cell body of the receiving neuron. The tiny gap at this junction is called the synaptic gap or synaptic cleft. (p. 85)
systematic desensitization — a type of exposure therapy that associates a pleasant relaxed state with gradually increasing anxiety-triggering stimuli. Commonly used to treat phobias. (p. 730)
telegraphic speech — early speech stage in which a child speaks like a telegram—“go car”—using mostly nouns and verbs. (p. 384)
temperament — a person’s characteristic emotional reactivity and intensity. (p. 511)
temporal lobes — the portion of the cerebral cortex lying roughly above the ears; includes the auditory areas, each receiving information primarily from the opposite ear. (p. 110)
tend-and-befriend response — under stress, people (especially women) often provide support to others (tend) and bond with and seek support from others (befriend). (p. 455)
teratogens — (literally, “monster makers”) agents, such as chemicals and viruses, that can reach the embryo or fetus during prenatal development and cause harm. (p. 490)
terror-management theory — a theory of death-related anxiety; explores people’s emotional and behavioral responses to reminders of their impending death. (p. 588)
testing effect — enhanced memory after retrieving, rather than simply rereading, information. Also sometimes referred to as a retrieval practice effect or test-enhanced learning. (pp. 20, 335)
testosterone — the most important male sex hormone. Both males and females have it, but the additional testosterone in males stimulates the growth of the male sex organs during the fetal period and the development of the male sex characteristics during puberty. (pp. 418, 545)
thalamus — [THAL-uh-muss] the brain’s sensory control center, located on top of the brainstem; it directs messages to the sensory receiving areas in the cortex and transmits replies to the cerebellum and medulla. (p. 102)
THC — the major active ingredient in marijuana; triggers a variety of effects, including mild hallucinations. (p. 262)
Thematic Apperception Test (TAT) — a projective test in which people express their inner feelings and interests through the stories they make up about ambiguous scenes. (p. 584)
theory — an explanation using an integrated set of principles that organizes observations and predicts behaviors or events. (p. 42)
theory of mind — people’s ideas about their own and others’ mental states—about their feelings, perceptions, and thoughts, and the behaviors these might predict. (p. 501)
therapeutic alliance — a bond of trust and mutual understanding between a therapist and client, who work together constructively to overcome the client’s problem. (p. 747)
threshold — the level of stimulation required to trigger a neural impulse. (p. 83)
token economy — an operant conditioning procedure in which people earn a token for exhibiting a desired behavior and can later exchange tokens for privileges or treats. (p. 732)
tolerance — the diminishing effect with regular use of the same dose of a drug, requiring the user to take larger and larger doses before experiencing the drug’s effect. (p. 255)
top-down processing — information processing guided by higher-level mental processes, as when we construct perceptions drawing on our experience and expectations. (p. 159)
trait — a characteristic pattern of behavior or a disposition to feel and act in certain ways, as assessed by self-report inventories and peer reports. (p. 596)
transduction — conversion of one form of energy into another. In sensation, the transforming of stimulus energies, such as sights, sounds, and smells, into neural impulses our brain can interpret. (p. 162)
transference — in psychoanalysis, the patient’s transfer to the analyst of emotions linked with other relationships (such as love or hatred for a parent). (p. 724)
transgender — an umbrella term describing people whose gender identity or expression differs from that associated with their birth-designated sex. (p. 526)
two-factor theory — the Schachter-Singer theory that to experience emotion one must (1) be physically aroused and (2) cognitively label the arousal. (p. 434)
two-word stage — beginning about age 2, the stage in speech development during which a child speaks mostly in two-word statements. (p. 384)
Type A — Friedman and Rosenman’s term for competitive, hard-driving, impatient, verbally aggressive, and anger-prone people. (p. 459)
Type B — Friedman and Rosenman’s term for easygoing, relaxed people. (p. 459)
unconditional positive regard — a caring, accepting, nonjudgmental attitude, which Carl Rogers believed would help clients develop self-awareness and self-acceptance. (pp. 592, 726)
unconditioned response (UR) — in classical conditioning, an unlearned, naturally occurring response (such as salivation) to an unconditioned stimulus (US) (such as food in the mouth). (p. 274)
unconditioned stimulus (US) — in classical conditioning, a stimulus that unconditionally—naturally and automatically—triggers an unconditioned response UR). (p. 274)
unconscious — according to Freud, a reservoir of mostly unacceptable thoughts, wishes, feelings, and memories. According to contemporary psychologists, information processing of which we are unaware. (p. 579)
validity — the extent to which a test or experiment measures or predicts what it is supposed to. (See also content validity and predictive validity.) (pp. 56, 636)
variable — anything that can vary and is feasible and ethical to measure. (p. 51)
variable-interval schedule — in operant conditioning, a reinforcement schedule that reinforces a response at unpredictable time intervals. (p. 288)
variable-ratio schedule — in operant conditioning, a reinforcement schedule that reinforces a response after an unpredictable number of responses. (p. 288)
vestibular sense — our sense of body movement and position that enables our sense of balance. (p. 213)
virtual reality exposure therapy — a counterconditioning technique that treats anxiety through creative electronic simulations in which people can safely face their greatest fears, such as airplane flying, spiders, or public speaking. (p. 730)
visual cliff — a laboratory device for testing depth perception in infants and young animals. (p. 189)
wavelength — the distance from the peak of one light or sound wave to the peak of the next. Electromagnetic wavelengths vary from the short blips of gamma rays to the long pulses of radio transmission. (p. 177)
Weber’s law — the principle that, to be perceived as different, two stimuli must differ by a constant minimum percentage (rather than a constant amount). (p. 165)
Wechsler Adult Intelligence Scale (WAIS) — the WAIS and its companion versions for children are the most widely used intelligence tests; they contain verbal and performance (nonverbal) subtests. (p. 635)
Wernicke’s area — a brain area involved in language comprehension and expression; usually in the left temporal lobe. (p. 388)
withdrawal — the discomfort and distress that follow discontinuing an addictive drug or behavior. (p. 255)
working memory — a newer understanding of short-term memory that adds conscious, active processing of incoming auditory and visual information, and of information retrieved from long-term memory. (p. 329)
X chromosome — the sex chromosome found in both males and females. Females typically have two X chromosomes; males typically have one. An X chromosome from each parent produces a female child. (p. 545)
Y chromosome — the sex chromosome typically found only in males. When paired with an X chromosome from the mother, it produces a male child. (p. 545)
Yerkes-Dodson law — the principle that performance increases with arousal only up to a point, beyond which performance decreases. (p. 404)
Young-Helmholtz trichromatic (three-color) theory — the theory that the retina contains three different types of color receptors—one most sensitive to red, one to green, one to blue—which, when stimulated in combination, can produce the perception of any color. (p. 181)
zygote — the fertilized egg; it enters a 2-week period of rapid cell division and develops into an embryo. (p. 489)
